{
  "AL":["",""],
  "AK":["",""],
  "AZ":["",""],
  "AR":["",""],
  "CA":[-8,""],
  "CO":["",""],
  "CT":["",""],
  "DE":["",""],
  "DC":["",""],
  "FL":[6,""],
  "GA":["",""],
  "HI":["",""],
  "ID":["",14],
  "IL":["",""],
  "IN":["",""],
  "IA":["",""],
  "KS":["",""],
  "KY":["",""],
  "LA":[-7,""],
  "ME":["",""],
  "MD":["",""],
  "MA":["",""],
  "MI":[8,12],
  "MN":["",""],
  "MS":["",""],
  "MO":["",""],
  "MT":["",""],
  "NE":["",""],
  "NV":["",""],
  "NH":["",10],
  "NJ":["",""],
  "NM":["",""],
  "NY":[3,""],
  "NC":["",""],
  "ND":["",""],
  "OH":["",""],
  "OK":["",""],
  "OR":["",""],
  "PA":["",""],
  "RI":["",""],
  "SC":["",""],
  "SD":["",""],
  "TN":["",5],
  "TX":["",""],
  "UT":["",""],
  "VT":["",-5],
  "VA":["",""],
  "WA":["",""],
  "WV":["",""],
  "WI":["",""],
  "WY":["",""],
  "AS":["",""],
  "FM":["",""],
  "GU":["",""],
  "MH":["",""],
  "MP":["",""],
  "PW":["",""],
  "PR":["",""],
  "VI":["",""]
}